Old Town Road - Lil Nas X (feat. Billy Ray Cyrus)
Bad Guy - Billie Eilish 
Senorita - Shawn Mendes & Camila Cabello 
I Don't Care - Ed Sheeran and Justin Bieber 
Sucker - Jonas Brothers 
7 rings - Ariana Grande
Highest in the Room - Travis Scott 
Please Me - Cardi B and Bruno Mars 
Circles - Post Malone 
Juice - Lizzo 
The Box - Roddy Ricch 
Don't Start Now - Dua Lipa 
Say So - Doja Cat
Memories - Maroon 5
If I Can't Have You - Shawn Mendes 
Walk Me Home - Pink 
Dancing with a Stranger - Same Smith and Normani 
Break Up With Your Girlfiend, I'm Bored - Ariana Grande 
Could've Been - H.E.R. (feat. Bryson Tiller)
Who Do You Love - The Chainsmokers (feat. 5 Seconds of Summer)
A Lot - 21 Savage (feat. J Cole)
Colors - Black Puma 
Beautiful People - Ed Sheeran (feat. Khalid)
Me! - Taylor Swift (feat. Brendon Urie)
Lo/Hi - The Black Keys
How Do You Sleep - Sam Smith
Bury a Friend - Billie Eilish 
Here with Me - Marshmello (feat. Chvches)
The London - Young Thug, J. Cole & Travis Scott
Liar - Camila Cabello
Roxanne - Arizona Zervas 
Loco Contigo - DJ Snake, J Balvin, & Tyga
Goodbyes - Post Malone (feat. Young Thug)
Spirit - Beyonce
Let Me Down Slowly - Alec Benjamin (feat. Alessia Cara)
Earfquake - Tyler, the Creator
Lights Up - Harry Styles
Boyfriend - Ariana Grande and Social House
Nightmare - Halsey
Woah - Lil Baby
No Guidance - Chris Brown (feat. Drake)
South of the Border - Ed Sheeran (feat. Camila Cabello and Cardi B)
Panini - Lil Nas X
Never Really Over - Katy Perry 
So Am I - Ava Max 
Own It - Stormzy (feat. Ed Sheeran and Burna Boy)
Hot Girl Summer - Megan Thee Stallion (feat. Nicki Minaj & Ty Dolla Sign)
Follow God - Kanye West
Lost in the Fire - Gesaffelstein and the Weeknd
Graveyard - Halsey 