WAP - Cardi B
Savage - Megan Thee Stallion
Rain on Me - Lady Gaga, Ariana Grande
Cardigan - Taylor Swift 
In Your Eyes - The Weeknd
I Can't Breathe - H.E.R. 
Savage Love - Jawsh 685 and Jason Derulo 
Rockstar - DaBaby
Kyoto - Phoebe Bridgers 
People, I've Been Sad - Christine and the Queens 
No Time to Die - Billie Eilish 
Mood - 24kGoldn (feat. Iann Dior)
The Scotts - Scotts
Describe - Perfume Genius 
Shameika - Fiona Apple 
Dynamite - BTS 
Whats Poppin - Jack Harlow 
Circle the Drain - Soccer Mommy
Level of Concern - Twenty One Pilots 
I Want You to Love Me - Fiona Apple 
Laugh Now Cry Later - Drake (feat. Lil Durk)
Stupid Love - Lady Gaga
If You're Too Shy (Let Me Know) - The 1975
Therefore I Am - Billie Eilish 
Physical - Dua Lipa 
Midnight Sky - Miley Cyrus 
August - Taylor Swift
Wonder - Shawn Mendes 
Save Your Tears - The Weeknd
Take You Dancing - Jason Derulo
Tossie Slide - Drake
My Ex's Best Friend - Machine Gun Kelly
The Bigger Picture - Lil Baby
Black Parade - Beyonce
Lost in Yesturday - Tame Impala 
Kings & Queens - Ava Max
Gospel for a New Country - Yves Tumor 
Dragonball Durag - Thundercat
Safaera - Bad Bunny x Jowell & Randy x Nengo Flow
Old Me - 5 Seconds of Summer
Do It - Chloe x Halle 
Death Bed (Coffee for Your Head) - Powfu (feat. Beabadoobee)
Rare - Selena Gomez 
Positions - Ariana Grande 
Exile - Taylor Swift (feat. Bon Iver)
America - Sufjan Stevens 
Godzilla - Eminem
Break My Heart - Dua Lipa
Heather - Conan Gray 
Life Is Good - Future (feat. Drake)