Feel Good Inc. - Gorillaz
Gold Digger - Kanye West
I Bet You Look Good On the Dancefloor - Arctic Monkeys
1 Thing - Amerie 
We Belong Together - Mariah Carey 
Hate It Or Love It - The Game (feat. 50 Cent)
Speed Of Sound - Coldplay 
Stay Fly - Three 6 Mafia
Do You Want To - Franz Fredinand 
Check On It - Beyonce
My Doorbell - The White Stripes 
Hoppipolla - Sigur Ros 
La Rock 01 - Vitalic 
Diamonds From Serra Leone - Kanye West
Chicago - Sufjan Stevens
Technologic - Daft Punk
Bad Day - Daniel Powter
Temperature - Sean Paul 
Hung Up - Madonna 
Hope There's Someone - Antony and The Johnsons
Don't Cha - The Pussycat Dolls
Candy Shop - 50 Cent
Ridin' - Chamillionaire and Krayzie Bone
Let's Make Love And Listen To Death From Above - CSS
Be Mine - Robyn 
You And Me - Lifehouse
Run It! - Chris Brown and Juelz Santana
Welcome to Jamrock - Damien Marley
I Write Sins Not Tragedies - Panic! at the Disco
Photograph - Nickelback
Sugar, We're Going Down - Fall Out Boy
How To Save A Life - The Fray 
Dirty Little Secret - The All-American Rejects
Fix You - Coldplay